                                                                                                              
                                                                                                              
               ========================================================~~.                                    
       //////////======================================================~~.                                    
    //////////////=========.====...==......===.....===........========.~~.                                    
    ///,,,/////////====..==..................==...==........S...==..%..~~.                                    
   ////,/,,////////=====.=====.........==........==...........i....==..~~.                                    
   ///,Y,B,//,,,//////==...==..........==........=====...........===..~~..                                    
  ///,,,,,,,,,,,,,/////===....===.......=...==....==.==..........==...~~..                                    
  ///,,,,,,/,,///,,/,//===.======...=...=======.......==........===..~~~..                                    
   //,,,/,,,,//,,,/,,,//=..=====...===.==.............==.......===..~~~...                                    
   ///,,,,/////,//,,,,//==...===%%%========............=%%%%==.===..~~~...                                    
   //////,/////,,,,/,,///=.=====...====..===...==...........=..==...~~....                                    
    /////,,,///,,/,,/////===..............==.===............==.==..~~.....                                    
     //////////,,//,//////=................=======.====....=====...~~.....                                    
    //////,,,,//,,,/////........................==============.....~~.....                                    
    ///,,/,,/,,///,,////...................#...........===........I~~I....                                    
    ///,,,/,,,//,,,///,...........oo...............................~~.....                                    
    ///,/,,/,,//,//,,,,........@.ooo.1.............==.......===.3..~~~....                                    
    ///,,///,,//,,,,,,//..........oo..............===============.v.~~....                                    
     ///,,,,,/////,,,,,/.2.......................===   == =    ====.~~....                                    
     //,,,//,,////,,,,,,.......................====             ===.~~....                                    
     //,/,,/,////,,,/////=...................==                  =...~~...                                    
     //,,/,,,,,/,,,,/////===............==..==                   ==..~~...                                    
    ////,,,,,/,,/,,////// ===..=.....=======                      =..~~~..                                    
    ///////,//,,,,,,,///    ===============                        =..~~..                                    
    //////,,,/,////,,,//     = =====   =                           ==.~~..                                    
   ///,,///,,,,////,,,///                                           ==~~..                                    
   ///,,,////,,///////////                                          ==~~..                                    
   //,,/,///,/,,,//////////                                          =~~..                                    
   ///,,,///,/,/,,///  //                                                                                     
   /////,////,,,/,//                                                                                          
    ////,,,//,/,,,///                                                                                         
     /////,//,,/,,///                                                                                         
     /////,,//,,,,///                                                                                         
      /////,,,,/////                                                                                          
       ////////////                                                                                           
        ////////                                                                                              
                                                                                                              
                                                                                                              
